0 0 0 0 0 0 0 0 0 7 8 9 0 0 7 8 8 9 0 0 0 0 0 0 0 7 8 8 8 8 9 0 0 0 0 
0 0 0 0 0 0 0 0 0 13 14 15 0 0 13 14 14 15 0 0 0 0 0 0 0 13 14 14 14 14 113 8 8 9 0 
0 0 0 0 0 0 0 0 0 10 11 12 0 0 10 11 11 12 0 0 0 0 0 0 0 10 11 11 11 11 20 14 14 15 0 
0 0 0 0 0 0 0 0 0 10 11 12 0 0 16 31 30 18 0 0 202 0 0 0 0 10 11 19 11 11 11 11 11 12 0 
0 7 8 8 9 0 7 8 8 22 11 21 8 8 8 22 21 8 8 8 204 8 9 0 0 10 11 11 11 115 116 11 11 12 0 
0 13 14 14 15 0 13 14 14 23 11 20 14 14 14 23 20 14 14 14 214 14 15 0 0 16 17 31 11 117 118 11 11 12 0 
0 10 11 11 12 0 10 11 11 11 11 11 11 11 11 11 11 11 11 11 11 11 12 0 0 0 0 10 11 11 11 11 11 12 0 
0 10 11 11 12 0 10 11 11 11 11 11 11 11 11 11 11 11 11 11 11 11 12 0 0 0 0 16 17 17 17 17 17 18 0 
0 16 17 17 18 0 16 17 17 17 17 17 17 17 17 17 17 17 17 17 17 17 18 0 0 0 0 0 0 0 0 0 0 0 0 